111111111111111
1C0000000000001
111000000000001
1000000000E0001
10000000P000001
1000000C0000001
1B0000000000001
111111111111111