1111111111
1C00000EC1
1001100011
1P01C00001
1111111111