11111111111111111111
11C00000C10000000011
11110011111110000001
1P000111111110000001
10000000000000000001
10000000000111000001
100000000011111100E1
11111000011111111111
1C000000111111111111
11111111111111111111