1111111111
1C000000C1
1001100011
1P01C000E1
1111111111