1111111111
1000000001
1001100011
1P01C000E1
1111111111