111111111111111111111111111111111111111111111111111111111111111111111111111111111111111111111111111111111111111111111111111111111111111111
1P0000000000000C000000000000000000000000000000000000000C000000000000000000000000000C0000000000000000000000000000000000000000000000000000E1
100001111111000000000000000000000000000000000000000111111111111111111000001111110000000111111111111111111000111111111100000111111111111111
1C0001000001000000000000000000000000000000000000000000000000000000000000000000000000000000000000000000000000000000000000000000000000000111
100000100000100000000000000000000000000000000000000000000000000000000000000000000000000000000000000000000000000000000000000000000000000011
111100100000111111111111111111111111111111111111111111111111111111111111111111111111111111111111111111111111111111111111111111111111111011
100000000000000000000000000000000000000000000000000000000000000000000000000000000000000000000000000000000000000000000000000000000000000011
100111111111100111111111111111111111111111111111111111111111111111111111111111111111111111111111111111111111111111111111111111111111111011
1000000C0000001000000000000000000000000000000000000000000000000000000000000000000000000000000000000000000000000000000000000000000000000011
111100000000000000000000000000000000000B00000000000000000000000000000000000000000000000000000000000000000000000000000000000000000000000011
100000000000000000000000000000000000000000000000000000000000000000000000000000000000000000000000000000000000000000000000000000000000000011
100111111111111111111111111111111111111111111111111111111111111111111111111111111111111111111111111111111111111111111111111111111111111111
100000000000000000000000000000000000000000000000000000000000000000000000000000000000000000000000000000000000000000000000000000000000000011
100000000C00000111111111111111111111111111111111111111111111111111111111111111111111111111111111111111111111111111111111111111111111111011
100000000000000000000000000000000000000000000000000000000000000000000000000000000000000000000000000000000000000000000000000000000000000011
100111111000001111111100000000000000000000000000000111111111101111111000000000000000000000000000000000000000000000000000111111111111111111
100000000000000000000000000000000000000000000000000000000000000000000000000000000000000000000000000000000000000000000000000000000000000011
100000000C00000111111111100000000000111111100000000000000000000000000000000000000000000000000000000000000000000000000000000000000000000011
100001111110000001000111111000000000001111111000000111111111111111111000001111110000000111111111111111111000111111111100000111111111111111
1C00010000010000010000100001000000001C0001000000C00000010000001C000000100000000010000100000C000000000000000000000C000000000000000000000011
111111111111111111111111111111111111111111111111111111111111111111111111111111111111111111111111111111111111111111111111111111111111111111