111111111
1P00C0001
1001100E1
100C00001
1C0101001
100C00001
111111111