11111111
1P00C0E1
10101001
1C000001
100C0101
10000001
11111111