111111111
110000C01
100E10001
100000001
1C0101011
100C00001
111111111