111111111111111111111111111111111111111111111111111111111111111
1P000000C000000001C0000000C0000000000000C0000000C000000000000E1
100001111110000001000111111000000000001111111000000111111111111
1C0001000001000001C000100001000000001C0001000000C00000010000001
100000100000100000100000000000000001000001000000001000000000001
111100100000111111111100000000000000000001000000001000000000001
100000000C0000000000000C000000C0000000010000000000000000C000001
100111111111100111111000000000000001111111111100001111111000001
1000000C0000001000000000000C000000001C0000000000000000000000001
111100000000000000000000000000000000000000000000000000000000001
100000000000000C000000000000000000001C000000000000000000000C001
100111111000001111111100000000000000000000000000000111111111101
100000000000000000000000000000C000000C000000000000000000000C001
100000000C00000111111111100000000000111111100000000000000000001
111111111111111111111111111111111111111111111111111111111111111