111111111
1P0000001
101111101
100000E01
1C1111111
110C00001
111111111