1111111111
1P000000C1
1111111101
1000E00101
1C01010101
100000C101
1111111111