111111111
1P000C0E1
101110101
100000001
1C0101001
100C0C001
111111111