1111111111
1P0000C001
1011101001
100000E001
1C01010001
1000C00001
1111111111