111111111
1P0000001
111111E01
100C0C101
1C0101011
100000001
111111111