111111111
1P000C0E1
100111001
1C000C001
101010001
100C00001
111111111