1111111111
1P00000C01
1001101001
10000E0001
1C01010101
100000C001
1111111111