111111111
1P00C0001
101010101
100C0C0E1
1C0101001
100000001
111111111