111111111
1P10C0001
110111101
1E000C001
1C0101001
100000C01
111111111