111111111111111111111111111111111111111111111111111111111111111111111111111111111111111111111111111111111111111111111111111111111111111
1P000000C000000001C0000000C0000000000000C0000000C000000000000E0000000000000000C0000000C000000C0000000C000000C00000000000000000000000001
100001111110000001000111111000000000001111111000000111111111111111111000001111110000000111111111111111111000111111111100000111111111101
1C0001000001000001C000100001000000001C0001000000C00000010000001C000000100000000010000100000C000000000000000000000C00000000000000000001
10000010000010000010000000000000000100000100000000100000000000000000000000000000000000000100000000000000000000000000000000000000000001
11110010000011111111110000000000000000000100000000100000000000000000000000000000000000000100000000000000000000000000000000000000000001
100000000C0000000000000C000000C0000000010000000000000000C000001000000C000000000C000000000C000000000000000000000000000000000C0000000001
10011111111110011111100000000000000111111111110000111111100000100000011111111111111111111111111111111111111111111111111111111111111101
1000000C0000001000000000000C000000001C000000000000000000000000000000000000000000000000000000000000000000000000000000000000000000000001
11110000000000000000000000000000000000000000000000000000000000000000000000000000000000000000000000000000000000000000000000000000000001
100000000000000C000000000000000000001C000000000000000000000C00100000000000000000000000000000000000000000000000000000000000000000000001
10011111100000111111110000000000000000000000000000011111111110111111100000000000000000000000000000000000000000000000000011111111111111
100000000000000000000000000000C000000C0000000000000000000000000000000000000000000000000000000000000000000000000000000000000000000000001
100000000C0000011111111110000000000011111110000000000000000000000000000000000000000000000000000000000000000000000000000000000000000001
100000000000000C000000000000000000001C000000000000000000000C00100000000000000000000000000000000000000000000000000000000000000000000001
10011111100000111111110000000000000000000000000000011111111110111111100000000000000000000000000000000000000000000000000011111111111111
100000000000000000000000000000C000000C0000000000000000000000000000000000000000000000000000000000000000000000000000000000000000000000001
100000000C0000011111111110000000000011111110000000000000000000000000000000000000000000000000000000000000000000000000000000000000000001
100001111110000001000111111000000000001111111000000111111111111111111000001111110000000111111111111111111000111111111100000111111111101
1C0001000001000001C000100001000000001C0001000000C00000010000001C000000100000000010000100000C000000000000000000000C00000000000000000001
111111111111111111111111111111111111111111111111111111111111111111111111111111111111111111111111111111111111111111111111111111111111111