111111111
1P00000E1
101010101
100C00001
1C0101011
1000C0001
111111111