111111111
1P0000C01
101111111
1010C0001
1C0111111
100000001
111111111