111111111
1P000C0C1
101110101
100001111
1C0101E01
100C0C101
111111111