1111111111
1P000C0001
1001111001
10000C0001
1C010100E1
100000C001
1111111111