11111111
1P000E01
100C0101
1C000001
10101001
10000001
11111111